짱구: 다드 더원 레이저 용도 착용 처음 판별 페이 포인트 확인 후망

다드 - 무신사 스탠다드, change
더원 - 오버더원, change
레이저 - 블레이저, change
용도 - 카페 글 양식에 나온 게시판별 사용 '용도', del
착용 - 애매함. 착용샷, 착용감도 있는 반면에 데일리룩 게시판 협찬제품 착용 제재 공지도 있음, remain
처음 - 구제에 처음 입문하는 사람이 많다는 뜻으로 사용이 많이 되고 있음, remain
판별 - 구제 상품이 진품인지 아닌지 판별해달라는 뜻. 다른 뜻으로도 쓰긴 씀, remain
페이 - 페이탈리즘, change
포인트 - 옷의 포인트는 이 꽃무늬이다 같은 뜻. 저는 포인트 적립의 의미인줄 알았네요.., remain
확인 - 판별과 마찬가지, remain
후망 - 브랜드 이름, remain


gocd: 고민 그냥 느낌 다른 다시 때문 마음 바로 보고 부분 사람
사실(사실 분 할때 사실인지 fact인지) 최근 추천 커피 하나 한번 확인

고민 - 구제 사는거 고민한다는 뜻, remain
그냥 - 그냥 쓰는 말. 삭제, del
느낌 - 이런 느낌의 팬츠 추천 부탁드려요, remain
다른 - 다른 빈티지샵들 둘러보세요 같은 의미로 쓰임, del
때문 - 특히 이 단어가 많이 나온 이유는 구제 특유의 사이즈, 착용감 문제 '때문' 에 어찌저찌하다 라는 말 때문인듯, remain
마음 - 마음을 편안히 했다, 마음에 드는 브랜드가 없다.. 그냥 일상적으로 사용하는 단어로 보임, del
바로 - 바로 구매했다, 빈티지 구매하자마자 드라이기로 말려야 한다, 바로 구멍이 뚫렸다 등, remain
보고 - 직접 이용해보고/착용해보고 구매하세요, change(착용해보고로)
부분 - 옷의 시보리부분이 마음에 안든다, 뭐가 문제가 생겼다, 이 부분이 너무 좋다, del
사람 - 일상적으로 사용하는 단어, del
사실 - del
최근 - del
추천 - del
커피 - del
하나 - one도 있고 그러기도 하나요?, del
한번 - del
확인 - 위의 판별과 마찬가지, remain

가요 - song 아니고 ~한가요?
가장 - the most
대한


무탠 - 무신사 스탠다드
델리 - 데일리
드하 - 이든메이드 라는 브랜드랑 하의랑 합쳐진 결과..이든메이드로 변경
로드 - 86로드
리즘 - 플레이버리즘
브릿지 - 유니폼브릿지
주얼 - 캐주얼
투시 - 나이키 스투시(줄여서 나투시)
하트 - 정말 그냥 하트 로고..
훈스 - 브랜드이름
